%s ago=%s 以前
%s used of %s %s %%=已使用 %s/%s，%s %%
1 m=1 分钟
10 s=10 秒
2 m=2 分钟
30 s=30 秒
5 m=5 分钟
Abort background operation=终止后台操作
Abort background process=终止后台进程
Active tunnels=活动隧道
Activity=活动
ago=以前
Airflow=风扇信息
Alert Message=警报信息
Alerts=警报
All Apps=显示所有容器(Docker)应用
All VMs=显示所有虚拟机
Array Information=磁盘阵列信息
Attention - operation continues in background=注意 - 操作在后台继续进行
Battery charge=电池电量
BIOS dated=BIOS 日期
Check free space=检查剩余空间
checking=检查中
Click to toggle CPU chart=单击以切换 CPU 视图
Click to toggle details=单击以切换详细信息
Clock is synchronized using %s NTP servers, time offset is %s %s=时钟使用 %s NTP 服务器同步，时间调整为 %s %s
Clock is synchronized using %s PTP server, time offset is %s %s=时钟使用 %s PTP 服务器同步，时间调整为 %s %s
Clock is unsynchronized with no NTP servers=时钟未与 NTP 服务器同步
Clock is unsynchronized with no PTP servers=时钟未同步，无PTP服务器
Clock is unsynchronized, free-running clock=时钟不同步，自由运行时钟
Clock synchronized with %s NTP server=时钟已与 %s 个 NTP 服务器同步
Clock synchronized with %s NTP servers=时钟已与 %s 个 NTP 服务器同步
Clone=克隆
Close Tile=关闭磁贴
Completed=已完成
Containers=容器
Content Management=内容管理
Counters info=计数器信息
Current operation %s on %s=当前操作 **%s** 于 **%s**
custom image=自定义镜像
Data is invalid=数据无效
default image=默认镜像
device warning=设备警告
device warnings=设备警告
Docker Containers=Docker 容器
Docker folder=Docker文件夹
Docker vdisk=Docker虚拟磁盘
Due in=剩余时间
Edit VM after clone=克隆后编辑虚拟机
Elapsed time=已运行时间
emulated=模拟
Errors info=错误信息
Estimated finish=预计完成
failed device=故障设备
Fan count=风扇数
Fan Information=风扇信息
FAN=风扇
Finding %s error=已发现: **%s** 个错误
Finding %s errors=已发现: **%s** 个错误
Flash device=闪存设备
Free=空闲
General info=常规信息
Go to CPU pinning settings=转到 CPU 绑定设置
Go to date and time settings=前往日期和时间设置
Go to disk settings=转到磁盘设置
Go to Docker settings=转到 Docker 设置
Go to fan settings=转到风扇设置
Go to identification settings=转到标识设置
Go to network settings=转到网络设置
Go to scheduler settings=转到计划程序设置
Go to Share settings=转到共享设置
Go to UPS settings=转到 UPS 设置
Go to User settings=转到用户设置
Go to VM settings=转到虚拟机设置
Go to VPN settings=转到 VPN 设置
Handshake=握手
has=有
healthy=运行良好
heat warning=过热警告
Hide details=隐藏详细信息
in progress=进行中
Inactive tunnels=非活动隧道
inactive=非活动
Inbound=下行速率
Information=信息
Interface Information=接口信息
invalid device=无效设备
invalid devices=无效设备
Last check completed on %s=上次完整检查于**%s**
Last check incomplete on %s=上次不完整检查于**%s**
Last checked on %s=上次检查于**%s**
Legend=图例
Lock sortable items=锁定可分拣项目
Log filesystem=日志文件系统
Maximum size=最大大小
Memory Utilization=内存使用
Mode of operation=操作模式
Motherboard Information=主板信息
Network traffic=网络流量
New VM=新虚拟机
Next check scheduled on %s=下次检查计划于**%s**
No docker containers defined=没有定义的 Docker 容器
No running docker containers=没有正在运行的 Docker 容器
No running virtual machines=没有正在运行的虚拟机
No shares present=不存在共享
No virtual machines defined=没有定义的虚拟机
Nominal power=额定功率
not received=未接收
Notices=提示
Notifications=通知
Only PNG images are allowed=只允许使用 PNG 格式的图像
Outbound=上行速率
Output voltage=输出电压
Overall Load=整体负载
Overwrite=覆盖
Parity disk not present=不存在奇偶校验磁盘
Parity disks not present=不存在奇偶校验磁盘
Parity has not been checked yet=目前未进行奇偶校验
Parity Information=奇偶校验信息
Parity is degraded=奇偶校验已降级
Percent of total used memory=总内存使用百分比
Percent usage of Docker folder=Docker 文件夹使用百分比
Percent usage of Docker vdisk=Docker 虚拟磁盘使用百分比
Percent usage of flash usb device=闪存 USB 设备使用百分比
Percent usage of LOG file system=日志文件系统使用百分比
Pool=池
Popup Blocked=Popup Blocked.
Power Status=电源信息
Power=电源
Processor Information=处理器信息
Put system to sleep=系统睡眠
RAM usage=内存使用
Reboot the system=系统重启
Receive counters=接收计数器
Received packets=已接收数据包
Runtime left=剩余运行时间
Scheduled parity check is disabled=计划的奇偶校验被禁用
Select Case Model=选择机箱型号
Select time frame=选择时间范围
Services=服务
Share count %s with %s cache only and %s encrypted=共享总计 **%s** 个，**%s** 个仅缓存，**%s** 个已加密
Shares Information=共享信息
Show details=显示详细信息
Show Information=显示信息
ShowHide All Content=显示/隐藏所有内容
ShowHide Content=显示/隐藏内容
Shutdown the system=关闭系统
SMART error=S.M.A.R.T. 错误
SMART health-check failed=S.M.A.R.T. 健康检查失败
SMART=S.M.A.R.T.
sn=序列号
Snapshot Name=快照名称
Snapshot=快照
Start Cloned VM=启动克隆的虚拟机
Start the array=启动磁盘阵列
Started only=仅显示已启动的
Stop the array=停止磁盘阵列
Temp=温度
This may leave an unknown state=这可能会导致一个未知状态
This will put the system to sleep=系统将睡眠
This will reboot the system=系统将重启
This will shutdown the system=系统将关闭
This will start the array=磁盘阵列将启动
This will stop the array=磁盘阵列将停止
Tile Management=标题管理
Transmit counters=传输计数器
Transmitted packets=已传输的数据包
Unassigned Devices=未分配的设备
Unlock sortable items=解锁可分拣项目
UPS Load=UPS 负载
UPS Model=UPS 型号
UPS status=UPS 状态
Usable size=可用大小
User count %s with %s unprotected=用户总计 **%s** 个，其中 **%s** 个未受保护
Users Information=用户信息
utilization warning=利用率警告
View Running Processes=查看正在运行的进程
Virtual Machines=虚拟机
VM Being Cloned=正在被克隆的虚拟机
VM Clone=虚拟机克隆
VM Name=虚拟机名称
VPN Connections=VPN 连接
W=瓦特
Warnings=警告信息
ZFS=ZFS
FS Native Snapshot=文件系统原生快照
grandmaster=主控节点
heat warnings=温度警告
invalid=无效
master=主节点
Memory dump=内存转储
No VMs running=没有正在运行的虚拟机
RX=接收（RX）
Share count %s with %s public SMB and %s public NFS=Share count: %s with %s public SMB and %s public NFS
SMART errors=共享数量：%s（含 %s 个公开 SMB 共享和 %s 个公开 NFS 共享）
SMART errors=SMART 错误
synching=正在同步
TX=发送（TX）
Unchecked will use QEMU External Snapshot=未选中时将使用 QEMU 外部快照
utilization warnings=使用率警告
Virtual Machines Usage=虚拟机使用情况
