3rd Party=第三方
Access Mode=访问模式
Add another Path, Port, Variable, Label or Device=添加另一个路径、端口、变量、标签或设备
Add Configuration=添加配置
Add=添加
Additional Requirements=额外要求
Addresses=地址
Always=总是
App to Host=应用到主机
Application=应用程序
apply update=应用更新
Are you sure=是否确定
Array must be Started to view Docker containers=必须**启动**磁盘阵列才能查看 Docker 容器
Autostart=自动启动
available=可用
Back=返回
Backup=备份
Beta=测试版
Books=书籍
By=来自
Categories=类别
Check for Updates=检查更新
Cloud=云
Compose=组成
Config Type=配置类型
Configuration not found=找不到配置
Connection Type=连接类型
Console shell command=控制台 shell 命令
Container ID=容器编号
Container IP=容器IP
Container not running=容器未运行
Container Path=容器路径
Container Port=容器端口
Container Size=容器大小
Container=容器
Container not found Try reloading this page to fix=找不到容器,请尝试重新加载此页面以修复
CPU Memory load=CPU 内存负载
CPU Pinning=CPU 绑定
Created=已创建
Crypto Currency=加密货币
Default Value=默认值
DERP Relay=DERP 中继
Device=设备
Display=显示
DNS=DNS
Docker Containers=Docker 容器
Docker Hub URL=Docker Hub 网址
Docker Service failed to start=Docker 服务无法启动
Downloaders=下载程序
Drivers=驱动
Edit Configuration=编辑配置
Error gathering Tailscale information from container=从容器中收集 Tailscale 信息时出错
Exit Node=退出节点
Exited=已退出
Expired RenewDisable key expiry=域名过期或自动续订失败
Extra Parameters=额外参数
Fixed IP address=固定 IP 地址
force update=强制更新
For security reasons, containers with Network Type Host should not have Tailscale enabled Please disable Tailscale in this container or change the Network Type of the container=出于安全原因,具有网络类型主机的容器不应启用Tailscale. 请在此容器中禁用Tailscale或更改容器的网络类型
FTP=FTP
Game Servers=游戏服务器
healthy=健康
Hide Buttons=隐藏按钮
Hide docker allocations=隐藏 Docker 分配
Hide more settings=隐藏更多设置
Home Automation=家庭自动化
Host Path=主机路径
Host Port=主机端口
Hostname=主机名称
HT=HT
Icon URL=图标链接
Image ID=镜像 ID
Is Exit Node=部署Exit Node
Key Expiry=密钥到期
Key=键
Label=标签
LAN IPPort=LAN IP:Port
Lock sortable items=锁定可排序项目
Management=管理
MediaApp=媒体应用
MediaServer=媒体服务器
Messenger=Messenger
Missing parameters=缺少参数
Music=音乐
Network Type=网络类型
No Docker containers installed=未安装 Docker 容器
None Listed=未列出
of=的
Online=在线
orphan image=孤立镜像
Other=其他
Overview=概述
Path=路径
Pause All=全部暂停
Photos=照片
Please check the logs and refresh the page=请检查日志并刷新页面
Please check the logs=请检查日志
Port Mappings=端口映射
Port=端口
Post Arguments=发布参数
Privileged=特权
Productivity=生产力
Project Page=项目页面
Proxy=代理
Pulling image=拉取镜像
Read Me First=先阅读此处
Read Only - Shared=只读-共享
Read Only - Slave=只读-从属
Read Only=只读
ReadWrite - Shared=读/写-共享
ReadWrite - Slave=读/写-从属
Real Hostname=真实主机名称
rebuild ready=重建就绪
rebuilding=正在重建
Remove template=移除模板
Removing container=正在移除容器
Removing orphan image=正在移除孤立镜像
Repository=存储库
Required=必填
Reset sorting=重置排序
Resume All=全部恢复
Routes=线路
Save=保存
Select a template=选择一个模板
Select categories=选择类别
Show docker allocations=显示 Docker 分配
Show more settings=显示更多设置
Stable=稳定
Start All=全部启动
starting up containers=正在启动容器
Stop All=全部停止
Stopping container=正在停止容器
Successfully removed container=成功移除容器
Successfully removed orphan image=成功移除孤立镜像
Successfully stopped container=成功停止容器
Support Thread=支持线程
Tailscale=Tailscale
Template URL=模板网址
Template=模板
The command failed=命令失败
The command finished successfully=命令成功完成
TOTAL DATA PULLED=**拉取的数据总量**
Total size=总大小
Unknown action=未知操作
Unlock sortable items=解锁可排序项目
Update All=全部更新
update available=可用更新
update ready=更新就绪
URL=网址
Value=值
Variable=变量
Video=视频
Voip=Voip
Volume Mappings=卷映射
wait=等待
Was this container created using this plugin=是否使用此插件创建该容器
Web=Web
WebUI=WebUI
Writable=可写
