Add Share=添加共享
All files encrypted=所有文件已加密
All files protected=所有文件已受保护
All files unprotected=所有文件未受保护
Allocation method=分配方法
Array must be Started to view Shares=必须**启动**磁盘阵列才能查看共享
Automatically split any directory as required=根据需要自动拆分任何目录
Automatically split only the top five directory levels as required=根据需要仅自动拆分前五个目录级别
Automatically split only the top four directory levels as required=根据需要仅自动拆分前四个目录级别
Automatically split only the top level directory as required=根据需要仅自动拆分顶层目录级别
Automatically split only the top three directory levels as required=根据需要仅自动拆分前三个目录级别
Automatically split only the top two directory levels as required=根据需要仅自动拆分前两个目录级别
Clean Up=清除
CLEAN UP=清除
Comments=备注
Compute All=全部计算
Compute=计算
Disk Shares=磁盘共享
Do not use pool names=请勿使用 池 的名称
Do not use reserved names=请勿使用 已保留 的名称
Enable Copy-on-write=启用写入复制
Enter a name for the share=输入共享名称
Excluded disks=已排除的磁盘
Exclusive access=唯一访问权
Export=共享
Fill-up=填满
Free Space will be calculated=计算空闲空间
Free=可用
has been deleted=已被删除
HDD=机械硬盘
High-water=High-water
Included disks=包含的磁盘
Invalid Characters=不可用的字符
Invalid share name=不可用的共享名称
is missing=缺失
it references storage that does not exist=引用了不存在的存储
It references storage that does not exist=引用了不存在的存储
Manual do not automatically split directories=手动操作，不要自动拆分目录
Minimum free space=最小可用空间
Missing share name=缺失共享名称
Most-free=高可用
Mover action=Mover 操作
Mover takes no action=Mover 未执行操作
Mover transfers files from array to cache=Mover 将文件从磁盘阵列传输到缓存
Mover transfers files from cache to array=Mover 将文件从缓存传输到磁盘阵列
Mover transfers files from Primary storage to Secondary storage=Mover 将文件从主存储传输到辅助存储
Mover transfers files from Secondary storage to Primary storage=Mover 将文件从辅助存储传输到主存储
next user share=下一个共享用户
No unused share configurations present=没有未使用的共享配置
Not used=未被使用
Only=只在
Prefer=首选
previous user share=之前的用户共享
Primary storage %s=主存储 %s
Primary storage for new files and folders=新文件和文件夹的主存储空间
Primary storage to Secondary storage=主存储到辅助存储
Read=读取
Recompute=重新计算
Remove unused share configurations=移除未被使用的共享设置
Removed share configurations=移除共享设置
Rule=规则
Secondary storage to Primary storage=从辅助存储到主存储
Secondary storage=辅助存储
Select cache pool=选择缓存池
Set when adding new share only=仅在添加新共享时设置
Share contains data=共享包含的数据
Share is empty and is safe to delete=共享资源为空可以安全删除
Share is empty=共享为空
Share is outside the list of designated disks=共享位于指定磁盘列表之外
Share must be empty to be deleted=共享资源必须为空才能删除
Share name contains invalid characters for ZFS use=共享名称包含对ZFS使用无效的字符
Share Settings=共享文件夹设置
Share status=共享状态
Size=大小
Some or all files unencrypted=部分或全部文件未加密
Some or all files unprotected=部分或全部文件未受保护
Split level=拆分级别
SSD=固态硬盘
Storage=存储
There are no exportable disk shares=没有可共享的磁盘共享
There are no exportable user shares=没有可共享的用户共享
There are no mountable array or pool disks - cannot add shares=没有可安装的硬盘阵列/硬盘池 - 无法添加共享
This share is invalid=共享无效
Time Machine volume size limit=时间机器卷大小限制
Unknown cache usage=未知缓存使用情况
Unknown encryption state=未知加密状态
Unknown protection status=未知保护状态
Use cache pool for new filesdirectories=(对新文件/目录)使用缓存池
User Shares=用户共享
Warning: Configured Pool=警告：池已配置
Write=写入
You cannot use the following within share names=您不能在共享名称中使用以下内容
There are no mounted array or pool disks - cannot add shares=There are no mounted array or pool disks - cannot add shares=没有已挂载的阵列或池磁盘，无法添加共享
